1111111111111
1E00CCCCC0001
1010C111C1001
1010C101C1001
1011C111C1101
1000CCCCC0001
10000000000P1
1111111111111
