111111111
1E00001C1
100011111
1000CC001
100011001
100000P01
111111111
