111111111
1E00000C1
100011111
1000CC001
100011001
100000P1
111111111